296 nonos [eures. st, rs, ss.

derioy. —iter revolvens: tornioy boeti oo lis roan-transiturus
erat: lte was ready to eross.
11. quantum: quantotooyius.

coaptare 48, 49.

Tmo Barnun on rue moronus Rrvnn ’

3. modo: oblative of modos, with instructis-ad conseren-
dum: sor beginning tle contest ot once.

4. praetori: Porcius-deta: est.

6. ibi: pronominal in force, =in iis and explained by in
vetere milite.

7. longior quam letior: G. 2993 A. 292.

8. Ea frons: the dextrum cornu, yo—dextra acies: i.'e. Ro-
⁴ mortorum. —eminens: :the line of the Romans was so long that
it extended beyond that of the enemy and so was not engaged. —-
arcebat: impedimerito erot. — adgrederentur: objectis Gallos,

10. in armis: with dorum—versi: sont, were driven. ¹

11. regi: historieel infinitive. - quorum: = utrorum.

12. quid: sor what purpose.

13. stationem segnem: where lte saw they would hold, o position of
no oetion, stotio us opposed to pugno.

14. post eciem: Romanam—hostibus . . . inopinantibus:
ablutive absolute-ostendissent: ie. the soldiers oi Claudius.
¹ -in terge: hostium.

16. pers: as plural, subject oi oberant and with it dilapsi stro-
tiqoo agrees, and corporo is in apposition. The effect ol this is
modified somewhat by the introduction oi the qui oderant clause.

17. hiantes: yospiny sor breotlr.

chapter 49.

1. fabrile scalprum: o carpenter's chisel—mogister: the
other term is rector. ’

2. sprevissent: subjunctive of indefinite repetition-cum
...tum: both . . . ond.

3. sustinuit: explained by hortando . . . obeundo.

4. fortuna: when fortune sooored tlte enemy (hostium).

 

